.............
..--.........
........--...
...........--
.----(.......
......._--...
...---.......
-------------