.............
..--.........
........--...
...........--
.----(.......
.......---...
...---.......
-------------