.........................|
..--..........--.........|
.......^--...........--..|
...........--..........--|
./---(......../---(......|
......._--.........._--..|
...---..........---.......
--------------------------
