.............
..--.........
........--...
...........--
./---(.......
......._--...
...---.......
-------------