..........................
..--..........--.........
.......^--...........--...
...........--..........--
./---(......../---(.......
......._--.........._--...
...---..........---.......
--------------------------
