--------------------------
|......................--|
|........................|
|......--................|
|........................|
|---..........--.........|
|......---...........$-..|
|..........--..........--|
|/---(......../---(......|
|......---..........---..|
|..---..........---......|
|------------------------|
