.............
..--.........
........--...
...........--
.-----.......
.......---...
...----.......
-------------