--------------------------
|......................--|
|........................|
|........................|
|........................|
|+--..........--.........|
|......^--...........$-..|
|..........--..........--|
|/---(......../---(......|
|......_--.........._--..|
|..---..........---.......
|-------------------------
