.........................|
..--..........--.........|
.......^--...........$-..|
...........--..........--|
./---(......../---(......|
......._--.........._--..|
...---..........---.......
--------------------------
