--------------------------
|......................--|
|.--.............---.....|
|........................|
|.......----.............|
|.--...........--........|
|.......--...........--..|
|..........--...........-|
|.----........----.......|
......._--...........--...
...---..........---.......
--------------------------
