..........................
..--...........--.........
........--...........--...
...........--...........--
./---(......../---(.......
......._--.........._--...
...---..........---.......
------------------------..
