--------------------------
|........................|
|...../-..........---...-|
|...........---..........|
|......-/-.........---...|
|.--...........^-........|
|.......--..........-/-..|
|..........---..........-|
|.-//..........-/--......|
.......---..........-----|
...---..........---......|
-------------------------|
