--------------------------
|........................|
|.....--..........---...-|
|...........---..........|
|......---.........---...|
|.--...........--........|
|.......--..........---..|
|..........---..........-|
|.---..........----......|
.......---..........-----|
...---..........---......|
-------------------------|
