--------------------------
|........................|
|.....--..........---...-|
|...........---..........|
|......---.........---...|
|.--...........--........|
|.......--..........---..|
|..........---..........-|
|.---..........----......|
|......---..........-----|
...---..........---......|
--------------------------
