---------------------
|...................|
|...................|
|..............-....|
|.---......--.....--|
|...................|
|.......--......._--|
|..---..............|
---------------------
